NO ./textures/wall_north.xpm
SO ./textures/wall_south.xpm
WE ./textures/wall_west.xpm
EA ./textures/wall_east.xpm

F 220,100,0
C 225,30,0

111111111111  1111111
100000000001111000001
100000000000000000001
1000000000N1111000001
100000000001  1000001
111111011111  1111111
     101        1
     101111  1111
   11100001111001
   10000000000001
   10000001111001
   11111111  1111
